2 3 4 7 5 17 18 19 20 21 657 658 659 660 661 80 168 107 197 0 81 82 83 84 85 721 722 723 724 725 145 146 147 148 149 785 786 787 788 789 209 210 211 212 213 849 850 851 852 853 273 274 275 276 277 913 914 915 916 917 337 338 339 340 341 977 978 979 980 981 401 402 403 404 405 1041 1042 1043 1044 1045 465 466 467 468 469 1105 1106 1107 1108 1109 529 530 531 532 533 1169 1170 1171 1172 1173 593 594 595 596 597 1233 1234 1235 1236 1237 -1

201 73 73 73 265 325 325 325 325 325 325 325 325 325 325 325 325 325 325 325 325 325 325 325 325 325 325 325 325 325 325 325 325 325 325 325 325 325 325 325 325 201 73 73 73 73 73 73 73 73 73 73 73 73 73 73 73 73 73 265 325 325 325 325
6 5 5 5 9 325 325 325 325 325 325 325 325 325 325 325 325 325 325 325 201 73 73 73 73 73 73 73 73 73 73 73 73 73 73 265 325 325 325 325 325 6 5 5 5 5 5 5 5 5 5 5 5 5 5 5 5 5 5 9 325 325 325 325
6 5 5 5 9 325 325 325 325 325 325 325 325 325 325 325 325 325 325 325 6 5 5 5 5 5 5 5 5 5 5 5 5 5 5 9 325 325 325 325 325 6 5 4 137 137 137 137 137 137 137 137 137 137 137 137 137 7 5 9 325 325 325 325
8 7 5 4 329 325 325 325 325 325 325 325 325 325 325 325 325 325 325 325 6 5 80 80 80 80 80 80 80 80 80 80 80 80 5 9 325 325 325 325 325 6 5 9 325 325 325 325 325 325 325 325 325 325 325 325 325 6 5 9 325 325 325 325
325 6 5 9 325 325 325 325 325 325 325 325 325 325 325 325 325 325 325 325 6 5 80 17 18 19 20 21 657 658 659 660 661 80 5 3 73 73 73 73 73 2 5 3 73 73 73 265 325 325 325 325 325 325 325 325 325 6 168 9 325 325 325 325
325 6 5 9 325 325 325 325 325 325 325 325 325 325 325 325 325 325 325 325 6 5 80 81 82 83 84 85 721 722 723 724 725 80 5 5 5 5 5 5 5 5 5 5 5 5 5 9 325 325 325 325 325 325 325 325 325 6 5 9 325 325 325 325
325 6 5 9 325 325 325 325 325 325 325 325 325 325 325 325 325 325 325 325 6 5 80 145 146 147 148 149 785 786 787 788 789 80 5 5 5 5 5 5 5 5 5 5 5 5 5 9 325 325 325 325 325 325 325 325 325 6 5 9 325 325 325 325
325 6 5 9 325 325 325 325 325 325 325 325 325 325 325 325 325 325 325 325 6 5 80 209 210 211 212 213 849 850 851 852 853 80 5 5 5 5 5 5 5 5 5 5 5 5 5 9 325 325 325 325 325 325 325 325 325 6 5 9 325 325 325 325
325 6 5 9 325 325 325 325 325 325 325 325 325 325 325 325 325 325 325 325 6 5 80 273 274 275 276 277 913 914 915 916 917 80 5 5 5 5 5 5 5 5 5 5 5 5 5 9 325 325 325 325 325 325 325 325 325 6 5 9 325 325 325 325
325 6 5 9 325 325 325 325 325 325 325 325 325 325 325 325 325 325 325 325 6 5 80 337 338 339 340 341 977 978 979 980 981 80 5 5 5 5 5 5 5 5 5 5 5 5 5 9 325 325 325 325 325 325 325 325 325 6 5 9 325 325 325 325
325 6 5 9 325 325 325 325 325 325 325 325 325 325 325 325 325 325 325 325 6 5 80 401 402 403 404 405 1041 1042 1043 1044 1045 80 5 5 5 5 5 5 583 707 707 707 707 519 5 9 325 325 325 325 325 325 325 325 325 6 5 9 325 325 325 325
325 6 5 9 325 325 325 325 325 325 325 325 325 325 325 325 325 325 325 325 6 5 80 465 466 467 468 469 1105 1106 1107 1108 1109 80 5 5 5 5 5 5 579 1560 1560 517 1560 518 5 9 325 325 325 325 325 325 325 325 325 6 5 9 325 325 325 325
325 6 5 9 325 325 325 325 325 325 325 325 325 325 325 325 325 325 325 325 6 5 80 529 530 531 532 533 1169 1170 1171 1172 1173 80 5 5 5 5 5 5 579 1688 1560 1688 1560 518 5 9 325 325 325 325 325 325 325 325 325 6 5 9 325 325 325 325
325 6 5 9 325 325 325 325 325 325 325 325 325 325 325 325 325 325 325 325 6 5 80 593 594 595 596 597 1233 1234 1235 1236 1237 80 5 5 5 5 5 5 584 770 770 770 770 520 5 9 325 325 325 325 325 325 325 325 325 6 5 9 325 325 325 325
325 6 5 3 73 73 73 73 73 73 73 73 73 73 73 73 73 73 265 325 6 5 80 80 80 80 80 80 80 80 80 80 80 80 5 5 5 5 5 5 5 5 5 5 5 5 5 9 325 325 325 325 325 325 325 325 325 6 5 9 325 325 325 325
325 6 5 5 5 5 5 5 5 5 5 5 5 5 5 5 5 5 3 265 6 5 5 5 5 5 5 5 5 5 5 5 5 5 4 137 137 137 137 137 137 137 137 137 137 137 137 329 325 325 325 325 325 325 325 325 325 6 168 9 325 325 325 325
325 6 5 5 5 5 5 5 5 5 4 137 137 137 137 137 7 5 5 9 8 137 137 137 137 137 137 137 137 137 137 137 137 137 329 325 325 325 325 325 325 325 325 325 325 325 325 325 325 325 325 325 325 325 325 325 325 6 5 9 325 325 325 325
325 6 5 5 5 5 1688 1688 5 5 9 325 325 325 325 325 6 5 5 9 325 325 325 325 325 325 325 325 325 325 325 325 325 325 325 325 325 325 325 325 325 325 325 325 325 325 325 325 325 325 325 325 325 325 325 325 325 6 5 9 325 325 325 325
325 6 5 5 5 5 1688 1376 5 5 9 325 325 325 325 325 6 5 5 3 73 73 73 73 73 73 73 73 73 73 73 73 73 261 261 261 261 73 73 265 325 325 325 325 325 325 325 325 325 325 325 325 325 325 325 325 325 6 5 9 325 325 325 325
325 6 5 5 5 5 1376 1376 5 5 9 325 325 325 325 325 6 5 5 5 107 107 107 107 107 107 107 107 107 107 107 107 107 107 107 107 107 5 5 3 265 325 325 325 325 325 325 325 325 325 325 325 325 325 325 325 325 6 5 9 325 325 325 325
325 6 5 5 5 5 5 5 5 5 9 325 325 325 325 325 6 5 5 4 137 137 137 137 137 137 137 137 137 137 137 137 137 137 137 137 137 7 5 5 3 265 325 325 325 325 325 325 325 325 325 325 325 325 325 325 325 6 5 9 325 325 325 325
325 6 5 5 1688 1688 1688 1688 5 5 9 325 325 325 325 325 6 5 5 9 325 325 325 325 325 325 325 325 325 325 325 325 201 73 73 73 73 2 5 5 5 3 73 73 73 73 73 265 325 325 325 325 325 325 325 325 325 6 5 9 325 325 325 325
325 8 7 5 5 5 5 5 5 4 329 325 325 325 325 325 6 5 5 9 325 325 325 325 325 325 325 325 325 325 325 325 6 1687 1560 5 5 5 5 5 5 5 5 5 5 1560 1560 9 325 325 325 325 325 325 325 325 325 6 5 9 325 325 325 325
325 325 8 137 137 137 137 137 137 329 325 325 325 325 325 325 6 5 5 9 325 325 325 325 325 325 325 325 325 325 325 325 6 1560 1623 1623 5 5 5 5 5 5 5 5 1560 1624 1559 9 325 325 325 325 325 325 325 325 325 6 5 9 325 325 325 325
325 325 325 325 325 325 325 325 325 325 325 325 325 325 325 325 6 5 5 9 325 325 325 325 325 325 325 325 325 325 325 325 6 1687 1623 1560 1560 5 5 5 5 5 5 5 5 1560 1559 9 325 325 325 325 325 325 325 325 325 6 5 9 325 325 325 325
325 325 325 325 325 325 325 325 325 325 325 325 325 325 325 325 6 5 5 9 325 325 325 325 325 325 325 325 325 325 325 325 6 1560 1560 5 5 5 5 5 5 5 5 5 5 1560 1624 9 325 325 325 325 325 325 325 325 325 6 168 9 325 325 325 325
325 325 325 325 325 325 325 325 325 325 325 325 325 325 325 325 6 5 5 9 325 325 325 325 325 325 325 325 325 325 325 325 6 5 5 5 5 5 5 5 5 5 5 5 5 5 1560 9 325 325 325 325 325 325 325 325 325 6 5 9 325 325 325 325
325 325 325 325 325 325 325 325 325 325 325 325 325 325 325 325 6 5 5 9 325 325 201 73 265 325 325 325 325 325 325 325 6 5 5 5 5 5 5 5 5 5 5 5 5 1559 1560 9 325 325 325 325 325 325 325 325 325 6 5 9 325 325 325 325
325 325 325 325 325 325 325 325 325 325 325 325 325 325 325 325 6 5 5 9 325 201 2 5 3 265 325 325 325 325 325 325 6 5 5 5 5 5 5 5 5 5 5 5 5 5 5 3 73 73 73 73 73 73 73 73 73 2 5 9 325 325 325 325
325 325 325 325 325 325 325 325 325 325 325 325 325 325 325 325 6 5 5 9 325 6 5 5 5 3 73 73 73 73 73 261 2 5 5 5 5 5 5 5 5 5 5 5 5 5 5 5 5 5 5 5 5 5 5 5 5 5 5 9 325 325 325 325
325 325 325 325 325 325 325 325 325 325 325 325 325 325 325 325 8 7 4 329 325 6 5 5 5 5 5 5 5 5 5 5 5 5 5 5 5 5 5 5 5 5 5 5 5 5 5 4 137 137 137 137 137 137 137 137 137 137 137 329 325 325 325 325
325 325 325 325 325 325 325 325 325 325 325 325 325 325 325 325 325 8 329 325 325 8 137 137 137 137 137 137 137 137 137 137 137 137 137 137 137 137 137 137 137 137 137 137 137 137 137 329 325 325 325 325 325 325 325 325 325 325 325 325 325 325 325 325

2 2
8 25
